- - - - - - - - - -
- - - - - - - - - -
- - - - - - - - - -
- - - - - - - - - -
- - - - - - - - - -
- - - - - - - - - -
- - - - - - - - - -
- - - - - - - - - -
- - - - - - - - - -
- - - - - - - - - -
s - - - - - - - - -
b - - - - - - - - -
- b - - - - - - - -
- - b - - - - - - -
- - - b - - - - - -
- - - - b - - - - -
- - - - - b - - - -
- - - - - - d - - -
- - - - - - - o - -
- - - - - - - - c -
