000000000000000000000000000000000000000000000000
000000000000000000000000000000000000000000000000
800060000000000000000000000000000000000000000000
000000000000000000000000000000000000000000000000
000000000000000000000000000000000000000000000000
011111111111111111111111111111111111111111111111
000000000000000000000000000000000000000000000000
000000000000000000000000000000000000000000000000
000000000000000000000000000000000000000000000000
000000000000000000000000000000000000000000000000
800000000200000000000000000000000000000000000000
000000000000000000000000000000000000000000000000
000000000000000000030000000000000000000000000000
000000000000000000000000000000000000000000000000
000000000006000000000000000000000000000000000000
000000000000000000000000000000000000000000000000
000000000000000000000000000000000000000000000000
000000000000000000000000000000000000000000000000